Id = item.Id,
CompanyLogo = item.CompanyLogo,
CompanyName = item.CompanyName,
CompanyAddress = item.CompanyAddress,
TermCondition = item.TermCondition,
RefNo = item.RefNo,
Date = item.Date,
ExtraRefNo = item.ExtraRefNo,
ExtraDate = item.ExtraDate,
FName = item.FName,
MName = item.MName,
LName = item.LName,
Address = item.Address,
PhoneNo = item.PhoneNo,
HomeNo = item.HomeNo,
WorkNo = item.WorkNo,
Email = item.Email,
PlateNo = item.PlateNo,
CarYear = item.CarYear,
CarBrand = item.CarBrand,
CarModel = item.CarModel,
TireSeason = item.TireSeason,
NoOfTires = item.NoOfTires,
TireSize1 = item.TireSize1,
TireSize2 = item.TireSize2,
TireSize3 = item.TireSize3,
TireSize4 = item.TireSize4,
IfStaggered = item.IfStaggered,
MakeModel = item.MakeModel,
RimAttached = item.RimAttached,
TypeRim = item.TypeRim,
DepthLF = item.DepthLF,
DepthLR = item.DepthLR,
DepthRF = item.DepthRF,
DepthRR = item.DepthRR,
BarcodeLF = item.BarcodeLF,
BarcodeLR = item.BarcodeLR,
BarcodeRF = item.BarcodeRF,
BarcodeRR = item.BarcodeRR,
TireStoredUpto = item.TireStoredUpto,
REP = item.REP,
Pic1 = item.Pic1,
Pic2 = item.Pic2,
Pic3 = item.Pic3,
Pic4 = item.Pic4,
CustomerSign = item.CustomerSign,
CusSignDate = item.CusSignDate,